@@@@..@@@....@@@....@@@....@@@....@@@....@@@....@@@..@@@@
@@@@..@@@....@@@....@@@....@@@....@@@....@@@....@@@..@@@@
@@@@..@@@....@@@....@@@....@@@....@@@....@@@....@@@..@@@@
@@@@.................................................@@@@
.........................................................
.........................................................
@@@......................................................
@@@......................................................
@@@.....@@@.@@@.@@@.@@@.@@@.@@@.@@@.@@@.@@@.@@@..........
........@@@.@@@.@@@.@@@.@@@.@@@.@@@.@@@.@@@.@@@..........
......................................................@@@
........@@@.@@@.@@@.@@@.@@@.@@@.@@@.@@@.@@@.@@@.......@@@
........@@@.@@@.@@@.@@@.@@@.@@@.@@@.@@@.@@@.@@@.......@@@
@@@......................................................
@@@.....@@@.@@@.@@@.@@@.@@@.@@@.@@@.@@@.@@@.@@@..........
@@@.....@@@.@@@.@@@.@@@.@@@.@@@.@@@.@@@.@@@.@@@..........
.........................................................
........@@@.@@@.@@@.@@@.@@@.@@@.@@@.@@@.@@@.@@@.......@@@
........@@@.@@@.@@@.@@@.@@@.@@@.@@@.@@@.@@@.@@@.......@@@
......................................................@@@
@@@.....@@@.@@@.@@@.@@@.@@@.@@@.@@@.@@@.@@@.@@@..........
@@@.....@@@.@@@.@@@.@@@.@@@.@@@.@@@.@@@.@@@.@@@..........
@@@......................................................
........@@@.@@@.@@@.@@@.@@@.@@@.@@@.@@@.@@@.@@@..........
........@@@.@@@.@@@.@@@.@@@.@@@.@@@.@@@.@@@.@@@.......@@@
......................................................@@@
......................................................@@@
.........................................................
.........................................................
@@@@.................................................@@@@
@@@@..@@@....@@@....@@@....@@@....@@@....@@@....@@@..@@@@
@@@@..@@@....@@@....@@@....@@@....@@@....@@@....@@@..@@@@
@@@@..@@@....@@@....@@@....@@@....@@@....@@@....@@@..@@@@
